0 0 15 17 19 23 24 38 46 47 52
1 1 10 21 40 41 43 48 50 54 59
2 6 8 11 14 18 30 32 51 53 58
3 4 5 20 25 26 27 31 34 42 56
4 2 3 7 12 16 22 29 35 49 57
5 9 13 28 33 36 37 39 44 45 55
nodes: 56   cpu: 0.04865915
