0 0 3 10 31 32 33 35 47 52 57
1 4 7 11 12 20 26 42 48 53 56
2 2 14 21 25 28 34 40 44 54 58
3 1 5 8 13 15 17 24 29 36 55
4 18 19 27 38 39 41 43 46 49 50
5 6 9 16 22 23 30 37 45 51 59
nodes: 83   cpu: 0.05467658
