0 0 7 12 20 24 39 45 48 51 57
1 2 3 10 15 26 28 30 47 50 54
2 1 19 25 27 35 41 44 46 49 58
3 5 11 13 14 17 29 33 40 42 43
4 8 16 18 21 22 32 52 53 55 59
5 4 6 9 23 31 34 36 37 38 56
nodes: 147   cpu: 0.11954563
