0 0 4 5 11 13 18 19 35 53 54
1 3 9 15 20 25 27 28 31 42 58
2 1 7 12 14 30 36 44 52 55 57
3 10 37 39 40 41 43 47 49 51 56
4 6 8 17 21 22 33 34 48 50 59
5 2 16 23 24 26 29 32 38 45 46
nodes: 1097   cpu: 0.320641
