0 0 1 11 17 26 28 37 46 52 56
1 4 14 18 19 21 22 29 35 54 59
2 8 10 12 13 33 39 42 43 45 53
3 3 6 9 36 38 40 41 47 55 57
4 5 7 15 23 24 30 32 49 50 51
5 2 16 20 25 27 31 34 44 48 58
nodes: 35   cpu: 0.06857692
